Totales,sintomaticos,Cases,Deaths,Vacunados,Efectividad,refuerzo,Efe refuerzo
2020-04-01,293,3030,16,0,0,0,0
2020-04-02,373,3403,18,0,0,0,0
2020-04-03,333,3736,22,0,0,0,0
2020-04-04,424,4160,27,0,0,0,0
2020-04-05,310,4470,34,0,0,0,0
2020-04-06,344,4814,37,0,0,0,0
2020-04-07,301,5115,43,0,0,0,0
2020-04-08,430,5545,48,0,0,0,0
2020-04-09,426,5971,57,0,0,0,0
2020-04-10,529,6500,65,0,0,0,0
2020-04-11,426,6926,73,0,0,0,0
2020-04-12,286,7212,80,0,0,0,0
2020-04-13,312,7524,82,0,0,0,0
2020-04-14,392,7916,92,0,0,0,0
2020-04-15,356,8272,94,0,0,0,0
2020-04-16,534,8806,105,0,0,0,0
2020-04-17,445,9251,116,0,0,0,0
2020-04-18,478,9729,126,0,0,0,0
2020-04-19,358,10087,133,0,0,0,0
2020-04-20,419,10506,139,0,0,0,0
2020-04-21,325,10831,147,0,0,0,0
2020-04-22,464,11295,160,0,0,0,0
2020-04-23,516,11811,168,0,0,0,0
2020-04-24,494,12305,174,0,0,0,0
2020-04-25,552,12857,181,0,0,0,0
2020-04-26,473,13330,189,0,0,0,0
2020-04-27,482,13812,198,0,0,0,0
2020-04-28,552,14364,207,0,0,0,0
2020-04-29,520,14884,216,0,0,0,0
2020-04-30,780,15664,227,0,0,0,0
2020-05-01,882,16546,234,0,0,0,0
2020-05-02,1246,17792,247,0,0,0,0
2020-05-03,1112,18904,260,0,0,0,0
2020-05-04,876,19780,270,0,0,0,0
2020-05-05,1317,21097,275,0,0,0,0
2020-05-06,893,21990,281,0,0,0,0
2020-05-07,1343,23333,285,0,0,0,0
2020-05-08,1183,24516,294,0,0,0,0
2020-05-09,1004,25520,304,0,0,0,0
2020-05-10,1406,26926,312,0,0,0,0
2020-05-11,975,27901,323,0,0,0,0
2020-05-12,1479,29380,335,0,0,0,0
2020-05-13,2152,31532,346,0,0,0,0
2020-05-14,2301,33833,368,0,0,0,0
2020-05-15,2112,35945,394,0,0,0,0
2020-05-16,1573,37518,421,0,0,0,0
2020-05-17,2024,39542,450,0,0,0,0
2020-05-18,2018,41560,478,0,0,0,0
2020-05-19,3099,44659,509,0,0,0,0
2020-05-20,3647,48306,544,0,0,0,0
2020-05-21,3538,51844,589,0,0,0,0
2020-05-22,3863,55707,630,0,0,0,0
2020-05-23,3237,58944,673,0,0,0,0
2020-05-24,3343,62287,718,0,0,0,0
2020-05-25,4428,66715,761,0,0,0,0
2020-05-26,3618,70333,806,0,0,0,0
2020-05-27,3956,74289,841,0,0,0,0
2020-05-28,4128,78417,890,0,0,0,0
2020-05-29,3355,81772,944,0,0,0,0
2020-05-30,3736,85508,997,0,0,0,0
2020-05-31,4437,89945,1054,0,0,0,0
2020-06-01,5082,95027,1113,0,0,0,0
2020-06-02,3206,98233,1188,0,0,0,0
2020-06-03,4537,102770,1275,0,0,0,0
2020-06-04,4172,106942,1356,0,0,0,0
2020-06-05,3790,110732,1448,0,0,0,0
2020-06-06,4888,115620,1541,0,0,0,0
2020-06-07,5760,121380,2190,0,0,0,0
2020-06-08,4237,125617,2264,0,0,0,0
2020-06-09,3587,129204,2283,0,0,0,0
2020-06-10,5226,134430,2475,0,0,0,0
2020-06-11,5089,139519,2648,0,0,0,0
2020-06-12,6217,145736,2870,0,0,0,0
2020-06-13,5969,151705,3101,0,0,0,0
2020-06-14,6368,158073,3323,0,0,0,0
2020-06-15,4660,162733,3362,0,0,0,0
2020-06-16,4498,167231,3383,0,0,0,0
2020-06-17,4320,171551,3615,0,0,0,0
2020-06-18,4060,175611,3841,0,0,0,0
2020-06-19,5016,180627,4093,0,0,0,0
2020-06-20,4564,185191,4295,0,0,0,0
2020-06-21,4181,189372,4479,0,0,0,0
2020-06-22,3710,193082,4502,0,0,0,0
2020-06-23,3078,196160,4505,0,0,0,0
2020-06-24,3020,199180,4731,0,0,0,0
2020-06-25,3778,202958,4903,0,0,0,0
2020-06-26,3422,206380,5068,0,0,0,0
2020-06-27,3481,209861,5347,0,0,0,0
2020-06-28,3396,213257,5509,0,0,0,0
2020-06-29,3092,216349,5575,0,0,0,0
2020-06-30,2690,219039,5688,0,0,0,0
2020-07-01,2134,221173,5753,0,0,0,0
2020-07-02,2042,223215,5920,0,0,0,0
2020-07-03,2703,225918,6051,0,0,0,0
2020-07-04,2951,228869,6192,0,0,0,0
2020-07-05,2852,231721,6308,0,0,0,0
2020-07-06,2354,234075,6384,0,0,0,0
2020-07-07,1946,236021,6434,0,0,0,0
2020-07-08,1638,237659,6573,0,0,0,0
2020-07-09,2395,240054,6682,0,0,0,0
2020-07-10,2392,242446,6781,0,0,0,0
2020-07-11,2219,244665,6881,0,0,0,0
2020-07-12,2371,247036,6979,0,0,0,0
2020-07-13,1985,249021,7024,0,0,0,0
2020-07-14,1444,250465,7069,0,0,0,0
2020-07-15,1400,251865,7186,0,0,0,0
2020-07-16,1949,253814,7290,0,0,0,0
2020-07-17,2125,255939,8347,0,0,0,0
2020-07-18,1624,257563,8445,0,0,0,0
2020-07-19,1615,259178,8503,0,0,0,0
2020-07-20,1599,260777,8633,0,0,0,0
2020-07-21,1342,262119,8677,0,0,0,0
2020-07-22,1391,263510,8722,0,0,0,0
2020-07-23,1841,265351,8838,0,0,0,0
2020-07-24,2005,267356,8914,0,0,0,0
2020-07-25,1752,269108,9020,0,0,0,0
2020-07-26,1620,270728,9112,0,0,0,0
2020-07-27,1475,272203,9187,0,0,0,0
2020-07-28,1236,273439,9240,0,0,0,0
2020-07-29,1294,274733,9278,0,0,0,0
2020-07-30,1428,276161,9377,0,0,0,0
2020-07-31,1540,277701,9457,0,0,0,0
2020-08-01,1426,279127,9533,0,0,0,0
2020-08-02,1482,280609,9608,0,0,0,0
2020-08-03,1119,281728,9707,0,0,0,0
2020-08-04,1049,282777,9745,0,0,0,0
2020-08-05,1216,283993,9792,0,0,0,0
2020-08-06,1383,285376,9889,0,0,0,0
2020-08-07,1479,286855,9958,0,0,0,0
2020-08-08,1511,288366,10011,0,0,0,0
2020-08-09,1452,289818,10077,0,0,0,0
2020-08-10,1319,291137,10139,0,0,0,0
2020-08-11,1061,292198,10178,0,0,0,0
2020-08-12,1071,293269,10205,0,0,0,0
2020-08-13,1343,294612,10299,0,0,0,0
2020-08-14,1396,296008,10340,0,0,0,0
2020-08-15,1158,297166,10395,0,0,0,0
2020-08-16,1383,298549,10452,0,0,0,0
2020-08-17,1012,299561,10513,0,0,0,0
2020-08-18,846,300407,10546,0,0,0,0
2020-08-19,876,301283,10578,0,0,0,0
2020-08-20,1265,302548,10671,0,0,0,0
2020-08-21,1328,303876,10723,0,0,0,0
2020-08-22,1267,305143,10792,0,0,0,0
2020-08-23,1315,306458,10852,0,0,0,0
2020-08-24,1265,307723,10916,0,0,0,0
2020-08-25,887,308610,10958,0,0,0,0
2020-08-26,993,309603,10990,0,0,0,0
2020-08-27,1197,310800,11072,0,0,0,0
2020-08-28,1227,312027,11132,0,0,0,0
2020-08-29,1330,313357,11181,0,0,0,0
2020-08-30,1277,314634,11244,0,0,0,0
2020-08-31,1177,315811,11289,0,0,0,0
2020-09-01,926,316737,11321,0,0,0,0
2020-09-02,1114,317851,11344,0,0,0,0
2020-09-03,1275,319126,11422,0,0,0,0
2020-09-04,1319,320445,11494,0,0,0,0
2020-09-05,1368,321813,11551,0,0,0,0
2020-09-06,1364,323177,11592,0,0,0,0
2020-09-07,1175,324352,11652,0,0,0,0
2020-09-08,839,325191,11682,0,0,0,0
2020-09-09,1048,326239,11702,0,0,0,0
2020-09-10,1139,327378,11781,0,0,0,0
2020-09-11,1304,328682,11850,0,0,0,0
2020-09-12,1407,330089,11895,0,0,0,0
2020-09-13,1413,331502,11949,0,0,0,0
2020-09-14,1064,332566,12013,0,0,0,0
2020-09-15,1025,333591,12040,0,0,0,0
2020-09-16,918,334509,12058,0,0,0,0
2020-09-17,1283,335792,12142,0,0,0,0
2020-09-18,1097,336889,12199,0,0,0,0
2020-09-19,1230,338119,12254,0,0,0,0
2020-09-20,1048,339167,12286,0,0,0,0
2020-09-21,832,339999,12298,0,0,0,0
2020-09-22,814,340813,12321,0,0,0,0
2020-09-23,1016,341829,12345,0,0,0,0
2020-09-24,1282,343111,12469,0,0,0,0
2020-09-25,1475,344586,12527,0,0,0,0
2020-09-26,1458,346044,12591,0,0,0,0
2020-09-27,1233,347277,12641,0,0,0,0
2020-09-28,1112,348389,12698,0,0,0,0
2020-09-29,1036,349425,12725,0,0,0,0
2020-09-30,1185,350610,12741,0,0,0,0
2020-10-01,1198,351808,12822,0,0,0,0
2020-10-02,1208,353016,12867,0,0,0,0
2020-10-03,1184,354200,12919,0,0,0,0
2020-10-04,1016,355216,12979,0,0,0,0
2020-10-05,984,356200,13037,0,0,0,0
2020-10-06,1019,357219,13070,0,0,0,0
2020-10-07,803,358022,13090,0,0,0,0
2020-10-08,1104,359126,13167,0,0,0,0
2020-10-09,1228,360354,13220,0,0,0,0
2020-10-10,1200,361554,13272,0,0,0,0
2020-10-11,1132,362686,13318,0,0,0,0
2020-10-12,941,363627,13379,0,0,0,0
2020-10-13,898,364525,13396,0,0,0,0
2020-10-14,822,365347,13415,0,0,0,0
2020-10-15,889,366236,13434,0,0,0,0
2020-10-16,1141,367377,13529,0,0,0,0
2020-10-17,1189,368566,13588,0,0,0,0
2020-10-18,1149,369715,13635,0,0,0,0
2020-10-19,1034,370749,13676,0,0,0,0
2020-10-20,726,371475,13702,0,0,0,0
2020-10-21,830,372305,13719,0,0,0,0
2020-10-22,1030,373335,13792,0,0,0,0
2020-10-23,1160,374495,13844,0,0,0,0
2020-10-24,1121,375616,13892,0,0,0,0
2020-10-25,1026,376642,13944,0,0,0,0
2020-10-26,1010,377652,14003,0,0,0,0
2020-10-27,569,378221,14026,0,0,0,0
2020-10-28,738,378959,14032,0,0,0,0
2020-10-29,1064,380023,14118,0,0,0,0
2020-10-30,965,380988,14158,0,0,0,0
2020-10-31,1077,382065,14207,0,0,0,0
2020-11-01,1031,383096,14247,0,0,0,0
2020-11-02,824,383920,14302,0,0,0,0
2020-11-03,688,384608,14319,0,0,0,0
2020-11-04,633,385241,14340,0,0,0,0
2020-11-05,1044,386285,14404,0,0,0,0
2020-11-06,1145,387430,14450,0,0,0,0
2020-11-07,1026,388456,14499,0,0,0,0
2020-11-08,1058,389514,14543,0,0,0,0
2020-11-09,836,390350,14588,0,0,0,0
2020-11-10,687,391037,14611,0,0,0,0
2020-11-11,636,391673,14633,0,0,0,0
2020-11-12,1145,392818,14699,0,0,0,0
2020-11-13,1012,393830,14738,0,0,0,0
2020-11-14,1093,394923,14777,0,0,0,0
2020-11-15,1029,395952,14819,0,0,0,0
2020-11-16,848,396800,14863,0,0,0,0
2020-11-17,656,397456,14883,0,0,0,0
2020-11-18,697,398153,14897,0,0,0,0
2020-11-19,1051,399204,14955,0,0,0,0
2020-11-20,1071,400275,15003,0,0,0,0
2020-11-21,1019,401294,15030,0,0,0,0
2020-11-22,961,402255,15069,0,0,0,0
2020-11-23,903,403158,15106,0,0,0,0
2020-11-24,702,403860,15131,0,0,0,0
2020-11-25,780,404640,15138,0,0,0,0
2020-11-26,1082,405722,15235,0,0,0,0
2020-11-27,1014,406736,15278,0,0,0,0
2020-11-28,1133,407869,15322,0,0,0,0
2020-11-29,993,408862,15356,0,0,0,0
2020-11-30,884,409746,15410,0,0,0,0
2020-12-01,747,410493,15430,0,0,0,0
2020-12-02,773,411266,15438,0,0,0,0
2020-12-03,1079,412345,15519,0,0,0,0
2020-12-04,1155,413500,15558,0,0,0,0
2020-12-05,1014,414514,15592,0,0,0,0
2020-12-06,1078,415592,15628,0,0,0,0
2020-12-07,1132,416724,15663,0,0,0,0
2020-12-08,958,417682,15680,0,0,0,0
2020-12-09,945,418627,15690,0,0,0,0
2020-12-10,1128,419755,15774,0,0,0,0
2020-12-11,1112,420867,15782,0,0,0,0
2020-12-12,1281,422148,15846,0,0,0,0
2020-12-13,1427,423575,15886,0,0,0,0
2020-12-14,1243,424818,15931,0,0,0,0
2020-12-15,1064,425882,15949,0,0,0,0
2020-12-16,1052,426934,15959,0,0,0,0
2020-12-17,1414,428348,16007,0,0,0,0
2020-12-18,1551,429899,16051,0,0,0,0
2020-12-19,1517,431416,16101,0,0,0,0
2020-12-20,1411,432827,16154,0,0,0,0
2020-12-21,1276,434103,16197,0,0,0,0
2020-12-22,1086,435189,16217,0,0,0,0
2020-12-23,1281,436470,16228,0,0,0,0
2020-12-24,1598,438068,16303,0,0,0,0
2020-12-25,1597,439665,16358,0,0,0,0
2020-12-26,1618,441283,16404,0,0,0,0
2020-12-27,1105,442388,16443,0,0,0,0
2020-12-28,1395,443783,16443,0,0,0,0
2020-12-29,1410,445193,16488,0,0,0,0
2020-12-30,1554,446747,16499,0,0,0,0
2020-12-31,2036,448783,16608,0,0,0,0
2021-01-01,2321,451104,16660,0,0,0,0
2021-01-02,2055,453159,16724,0,0,0,0
2021-01-03,1492,454651,16767,0,0,0,0
2021-01-04,1751,456402,16767,0,0,0,0
2021-01-05,1885,458287,16788,0,0,0,0
2021-01-06,1896,460183,16816,0,0,0,0
2021-01-07,2614,462797,16913,0,0,0,0
2021-01-08,2685,465482,16974,0,0,0,0
2021-01-09,2762,468244,17037,0,0,0,0
2021-01-10,2663,470907,17096,0,0,0,0
2021-01-11,2451,473358,17162,0,0,0,0
2021-01-12,2043,475401,17182,0,0,0,0
2021-01-13,2328,477729,17204,1032,0,0,0
2021-01-14,2725,480454,17294,5829,0.007239206,0,0
2021-01-15,2899,483353,17369,8304,0.033783558,0,0
2021-01-16,2677,486030,17435,8371,0.074074782,0,0
2021-01-17,2777,488807,17477,8371,0.114963671,0,0
2021-01-18,2430,491237,17547,8371,0.15585256,0,0
2021-01-19,2283,493520,17573,8372,0.196717949,0,0
2021-01-20,2468,495988,17594,8372,0.237606838,0,0
2021-01-21,3049,499037,17702,8372,0.278495726,0,0
2021-01-22,3296,502333,17786,8376,0.319232092,0,0
2021-01-23,2760,505093,17854,8376,0.360120981,0,0
2021-01-24,2822,507915,17933,8376,0.401009869,0,0
2021-01-25,2534,510449,17999,9779,0.378499233,0,0
2021-01-26,2054,512503,18023,10374,0.395334147,0,0
2021-01-27,2423,514926,18040,10408,0.434798019,0,0
2021-01-28,2896,517822,18174,10408,0.475686908,0,0
2021-01-29,2941,520763,18257,10413,0.516327753,0,0
2021-01-30,2622,523385,18339,10413,0.557216642,0,0
2021-01-31,2628,526013,18452,10414,0.598048098,0,0
2021-02-01,2278,528291,18537,10414,0.638936987,0,0
2021-02-02,2015,530306,18559,10420,0.679434421,0,0
2021-02-03,1828,532134,18576,10420,0.72032331,0,0
2021-02-04,2456,534590,18731,12528,0.633128282,0,0
2021-02-05,2445,537035,18808,13199,0.638101405,0,0
2021-02-06,2616,539651,18895,13204,0.667763523,0,0
2021-02-07,2411,542062,18974,13207,0.685900137,0,0
2021-02-08,2191,544253,19056,24990,0.370015002,0,0
2021-02-09,1911,546164,19084,44379,0.223417517,0,0
2021-02-10,1792,547956,19105,52726,0.215760949,0,0
2021-02-11,2600,550556,19262,55615,0.236962258,0,0
2021-02-12,2756,553312,19345,55825,0.270473929,0,0
2021-02-13,2537,555849,19443,55858,0.304850601,0,0
2021-02-14,2502,558351,19541,55858,0.33940971,0,0
2021-02-15,2172,560523,19624,55858,0.373967306,0,0
2021-02-16,1782,562305,19644,55870,0.408437158,0,0
2021-02-17,1779,564084,19659,55870,0.442465975,0,0
2021-02-18,2596,566680,19798,55871,0.47573131,0,0
2021-02-19,2470,569150,19897,55872,0.508758519,0,0
2021-02-20,2550,571700,19974,55872,0.541782129,0,0
2021-02-21,2410,574110,20042,55872,0.574803849,0,0
2021-02-22,2331,576441,20126,55894,0.60758444,0,0
2021-02-23,1563,578004,20151,55934,0.640148874,0,0
2021-02-24,1998,580002,20173,56108,0.671089043,0,0
2021-02-25,2913,582915,20310,56253,0.702323945,0,0
2021-02-26,3210,586125,20400,56371,0.733852442,0,0
2021-02-27,3088,589213,20476,56375,0.766092874,0,0
2021-02-28,2612,591825,20572,56375,0.797355743,0,0
2021-03-01,2732,594557,20660,56786,0.82240755,0,0
2021-03-02,1963,596520,20684,69206,0.700407578,0,0
2021-03-03,2387,598907,20704,223362,0.226439279,0,0
2021-03-04,3192,602099,20838,389267,0.152289885,0,0
2021-03-05,3671,605770,20928,551045,0.136482753,0,0
2021-03-06,3508,609278,21008,575197,0.171265206,0,0
2021-03-07,3562,612840,21077,582098,0.21110847,0,0
2021-03-08,3157,615997,21163,796265,0.185338777,0,0
2021-03-09,2464,618461,21182,1033894,0.176375347,0,0
2021-03-10,3024,621485,21206,1299562,0.175684549,0,0
2021-03-11,3912,625397,21362,1545318,0.185578442,0,0
2021-03-12,4123,629520,21451,1768580,0.201749563,0,0
2021-03-13,4052,633572,21574,1794776,0.243680947,0,0
2021-03-14,3911,637483,21674,1798615,0.288626538,0,0
2021-03-15,3390,640873,21772,2071178,0.290213707,0,0
2021-03-16,3303,644176,21789,2314910,0.300571011,0,0
2021-03-17,3323,647499,21816,2531028,0.316567748,0,0
2021-03-18,4391,651890,21988,2717258,0.334623665,0,0
2021-03-19,4482,656372,22087,2872095,0.354390441,0,0
2021-03-20,4711,661083,22180,2883115,0.390485282,0,0
2021-03-21,4590,665673,22279,2884288,0.427531005,0,0
2021-03-22,4142,669815,22359,3006368,0.445771246,0,0
2021-03-23,3532,673347,22384,3097054,0.465750276,0,0
2021-03-24,3795,677142,22402,3161909,0.486238092,0,0
2021-03-25,4971,682113,22524,3217207,0.504356127,0,0
2021-03-26,5206,687319,22587,3268402,0.519677885,0,0
2021-03-27,5135,692454,22653,3271155,0.539879587,0,0
2021-03-28,4787,697241,22754,3271579,0.560097995,0,0
2021-03-29,4668,701909,23070,3387161,0.560531667,0,0
2021-03-30,3427,705336,23107,3531979,0.554205441,0,0
2021-03-31,4581,709917,23135,3685250,0.546076097,0,0
2021-04-01,5292,715209,23328,3853902,0.535889715,0,0
2021-04-02,5348,720557,23421,3859117,0.548949784,0,0
2021-04-03,5334,725891,23524,3860466,0.5608412,0,0
2021-04-04,4818,730709,23644,3860935,0.572751161,0,0
2021-04-05,4115,734824,23677,4065963,0.555235757,0,0
2021-04-06,4010,738834,23734,4212771,0.547968652,0,0
2021-04-07,4194,743028,23796,4351273,0.542899114,0,0
2021-04-08,5653,748681,23979,4514174,0.535835469,0,0
2021-04-09,6280,754961,24108,4662336,0.531759904,0,0
2021-04-10,5378,760339,24213,4677185,0.54369031,0,0
2021-04-11,5162,765501,24346,4678542,0.557066286,0,0
2021-04-12,4039,769540,24483,4837580,0.551782134,0,0
2021-04-13,3867,773407,24518,4998015,0.547062602,0,0
2021-04-14,4220,777627,24548,5148314,0.543878683,0,0
2021-04-15,5171,782798,24766,5293339,0.541319151,0,0
2021-04-16,4990,787788,24923,5429302,0.539517016,0,0
2021-04-17,5167,792955,25055,5443697,0.550901769,0,0
2021-04-18,4686,797641,25177,5445464,0.563625644,0,0
2021-04-19,4184,801825,25277,5596766,0.560945788,0,0
2021-04-20,3457,805282,25317,5747035,0.55813434,0,0
2021-04-21,3716,808998,25353,5893586,0.556058083,0,0
2021-04-22,4624,813622,25532,6038054,0.554495958,0,0
2021-04-23,5038,818660,25641,6181961,0.553025459,0,0
2021-04-24,4480,823140,25742,6193913,0.563317775,0,0
2021-04-25,4386,827526,25856,6194606,0.57456419,0,0
2021-04-26,3854,831380,25975,6348381,0.571676008,0,0
2021-04-27,2863,834243,26020,6481000,0.570812459,0,0
2021-04-28,3370,837613,26073,6606770,0.570489465,0,0
2021-04-29,4738,842351,26247,6731448,0.570084085,0,0
2021-04-30,4842,847193,26353,6768471,0.57679987,0,0
2021-05-01,4285,851478,26457,6769682,0.585646833,0,0
2021-05-02,4115,855593,26561,6770348,0.594277757,0,0
2021-05-03,3133,858726,26659,6846339,0.596218877,0,0
2021-05-04,2303,861029,26696,6935050,0.59657471,0,0
2021-05-05,2919,863948,26726,7028812,0.596233575,0,0
2021-05-06,4291,868239,26895,7105601,0.597050845,0,0
2021-05-07,4554,872793,27004,7169599,0.598521069,0,0
2021-05-08,4251,877044,27101,7177817,0.604086827,0,0
2021-05-09,3714,880758,27218,7178264,0.610186027,0,0
2021-05-10,3478,884236,27318,7248839,0.610279322,0,0
2021-05-11,2722,886958,27356,7334283,0.608710058,0,0
2021-05-12,3221,890179,27384,7412879,0.607568921,0,0
2021-05-13,4355,894534,27520,7473633,0.607569475,0,0
2021-05-14,4524,899058,27647,7529994,0.607359188,0,0
2021-05-15,4733,903791,27734,7530403,0.611558792,0,0
2021-05-16,4406,908197,27832,7530576,0.615590501,0,0
2021-05-17,3645,911842,27934,7577766,0.615708888,0,0
2021-05-18,2908,914750,27965,7625589,0.615671409,0,0
2021-05-19,3837,918587,27997,7666936,0.616047644,0,0
2021-05-20,5394,923981,28169,7730399,0.614400403,0,0
2021-05-21,5145,929126,28290,7731795,0.617633475,0,0
2021-05-22,5104,934230,28386,7738085,0.620133522,0,0
2021-05-23,4273,938503,28518,7738675,0.623044726,0,0
2021-05-24,3952,942455,28548,7799923,0.621085973,0,0
2021-05-25,3219,945674,28585,7856932,0.619643677,0,0
2021-05-26,4182,949856,28624,7905376,0.619034864,0,0
2021-05-27,5769,955625,28809,7941747,0.61936665,0,0
2021-05-28,5900,961525,28928,7982766,0.619211264,0,0
2021-05-29,5703,967228,29047,7988566,0.621693756,0,0
2021-05-30,5295,972523,29168,7989543,0.624428297,0,0
2021-05-31,4489,977012,29300,8049381,0.622518005,0,0
2021-06-01,3571,980583,29344,8131496,0.619871142,0,0
2021-06-02,4339,984922,29385,8226700,0.617378666,0,0
2021-06-03,5715,990637,29598,8335002,0.615139199,0,0
2021-06-04,5827,996464,29696,8437953,0.612712629,0,0
2021-06-05,5959,1002423,29816,8460944,0.614515044,0,0
2021-06-06,5094,1007517,29937,8463975,0.617035972,0,0
2021-06-07,4459,1011976,30058,8591658,0.612214516,0,0
2021-06-08,3863,1015839,30104,8716341,0.60749246,0,0
2021-06-09,4196,1020035,30141,8833518,0.603542045,0,0
2021-06-10,5396,1025431,30339,8940399,0.600469347,0,0
2021-06-11,5413,1030844,30472,9038884,0.597748581,0,0
2021-06-12,5143,1035987,30579,9048689,0.601161959,0,0
2021-06-13,4984,1040971,30707,9049336,0.605188823,0,0
2021-06-14,4012,1044983,30804,9166121,0.601599555,0,0
2021-06-15,3213,1048196,30865,9291917,0.597801096,0,0
2021-06-16,3574,1051770,30922,9413370,0.594577031,0,0
2021-06-17,4620,1056390,31140,9526578,0.591926378,0,0
2021-06-18,4542,1060932,31259,9572483,0.593515879,0,0
2021-06-19,4224,1065156,31392,9592667,0.596367932,0,0
2021-06-20,3935,1069091,31513,9594830,0.600284587,0,0
2021-06-21,3452,1072543,31645,9607283,0.603359737,0,0
2021-06-22,2419,1074962,31690,9816830,0.593652442,0,0
2021-06-23,2165,1077127,31746,9993118,0.587140155,0,0
2021-06-24,2760,1079887,31797,10198074,0.58223326,0,0
2021-06-25,3933,1083820,32012,10371333,0.578543628,0,0
2021-06-26,3540,1087360,32163,10413206,0.580255507,0,0
2021-06-27,3032,1090392,32298,10417846,0.583678018,0,0
2021-06-28,2596,1092988,32454,10422236,0.586972096,0,0
2021-06-29,1827,1094815,32489,10631959,0.579689026,0,0
2021-06-30,1676,1096491,32545,10789037,0.57534078,0,0
2021-07-01,2033,1098524,32588,10885066,0.574114892,0,0
2021-07-02,2825,1101349,32809,10961532,0.5738085,0,0
2021-07-03,2659,1104008,32973,10983987,0.576145657,0,0
2021-07-04,2253,1106261,33103,10986502,0.579401879,0,0
2021-07-05,1803,1108064,33249,11094088,0.577380755,0,0
2021-07-06,1309,1109373,33288,11180910,0.576673021,0,0
2021-07-07,1437,1110810,33328,11269376,0.575446767,0,0
2021-07-08,2160,1112970,33514,11368090,0.573358906,0,0
2021-07-09,1882,1114852,33636,11457092,0.571584585,0,0
2021-07-10,1748,1116600,33767,11480555,0.5729009,0,0
2021-07-11,1442,1118042,33877,11483274,0.5750867,0,0
2021-07-12,1310,1119352,33980,11614040,0.570723006,0,0
2021-07-13,910,1120262,34016,11718051,0.568159112,0,0
2021-07-14,966,1121228,34049,11826352,0.565423795,0,0
2021-07-15,1512,1122740,34207,11922307,0.563454031,0,0
2021-07-16,1301,1124041,34309,11925021,0.565793459,0,0
2021-07-17,1148,1125189,34403,11938973,0.567273673,0,0
2021-07-18,881,1126070,34514,11940280,0.569198132,0,0
2021-07-19,679,1126749,34539,12016100,0.567360828,0,0
2021-07-20,625,1127374,34569,12110466,0.56460157,0,0
2021-07-21,776,1128150,34611,12182025,0.563044406,0,0
2021-07-22,1273,1129423,34792,12224646,0.562653851,0,0
2021-07-23,1112,1130535,34875,12282639,0.560950309,0,0
2021-07-24,954,1131489,34958,12294236,0.561151723,0,0
2021-07-25,948,1132437,35026,12295140,0.561609232,0,0
2021-07-26,723,1133160,35119,12336499,0.560030047,0,0
2021-07-27,527,1133687,35151,12378353,0.558136749,0,0
2021-07-28,638,1134325,35176,12406511,0.556565585,0,0
2021-07-29,916,1135241,35295,12488294,0.55206832,0,0
2021-07-30,882,1136123,35366,12556777,0.548073337,0,0
2021-07-31,762,1136885,35448,12566941,0.546885743,0,0
2021-08-01,756,1137641,35528,12567377,0.546063646,0,0
2021-08-02,584,1138225,35616,12592109,0.544077902,0,0
2021-08-03,395,1138620,35640,12618377,0.541854271,0,0
2021-08-04,505,1139125,35671,12678399,0.537918894,0,0
2021-08-05,863,1139988,35806,12721489,0.534663523,0,0
2021-08-06,738,1140726,35880,12753252,0.531834997,0,0
2021-08-07,602,1141328,35951,12754182,0.530315374,0,0
2021-08-08,452,1141780,36016,12754208,0.528785063,0,0
2021-08-09,557,1142337,36107,12775701,0.526265438,0,0
2021-08-10,309,1142646,36138,12795460,0.523791299,42,0
2021-08-11,430,1143076,36157,12913483,0.517116229,70080,0
2021-08-12,744,1143820,36243,12992997,0.512306694,159906,0.013802017
2021-08-13,578,1144398,36287,13042220,0.508844911,256697,0.028304695
2021-08-14,541,1144939,36331,13043242,0.507410719,260156,0.05927526
2021-08-15,600,1145539,36380,13043443,0.505917611,260246,0.091018923
2021-08-16,449,1145988,36420,13065913,0.503446721,418483,0.076365065
2021-08-17,278,1146266,36438,13092809,0.500895018,596459,0.075832359
2021-08-18,399,1146665,36456,13171228,0.496196241,706383,0.0907836
2021-08-19,584,1147249,36524,13232010,0.492365883,813835,0.106345237
2021-08-20,514,1147763,36566,13288511,0.488839627,906052,0.124057826
2021-08-21,476,1148239,36605,13291503,0.487366895,909341,0.155310003
2021-08-22,429,1148668,36650,13292319,0.485735281,909763,0.187048266
2021-08-23,382,1149050,36688,13322099,0.483029255,973953,0.204447439
2021-08-24,245,1149295,36701,13344849,0.48058422,1047672,0.219697814
2021-08-25,279,1149574,36718,13362211,0.478291117,1129262,0.23345094
2021-08-26,505,1150079,36778,13443418,0.473573305,1230708,0.243441235
2021-08-27,426,1150505,36807,13497548,0.470009321,1308636,0.258784705
2021-08-28,376,1150881,36841,13499741,0.468330466,1310476,0.289979054
2021-08-29,368,1151249,36885,13500306,0.466578607,1310695,0.321520788
2021-08-30,295,1151544,36923,13581584,0.462010676,1405211,0.329373517
2021-08-31,214,1151758,36937,13676195,0.457229939,1496048,0.338791928
2021-09-01,267,1152025,36945,13710836,0.45469671,1616970,0.342169346
2021-09-02,381,1152406,36995,13735525,0.452554653,1731399,0.348393327
2021-09-03,321,1152727,37041,13753643,0.450521863,1814279,0.361167771
2021-09-04,295,1153022,37067,13754482,0.448795975,1815926,0.38931803
2021-09-05,261,1153283,37090,13754641,0.44690273,1816041,0.416053275
2021-09-06,252,1153535,37108,13816263,0.44293754,1894342,0.42361804
2021-09-07,156,1153691,37115,13879541,0.43907375,1998614,0.426138926
2021-09-08,241,1153932,37122,13895491,0.436896477,2131967,0.422815586
2021-09-09,316,1154248,37159,13907163,0.434859373,2256492,0.420916857
2021-09-10,324,1154572,37178,13916715,0.432794358,2380825,0.418850729
2021-09-11,310,1154882,37201,13917333,0.430831245,2383382,0.438373729
2021-09-12,200,1155082,37232,13917392,0.428716955,2383618,0.456937599
2021-09-13,230,1155312,37253,13957303,0.425272066,2470835,0.458116513
2021-09-14,179,1155491,37253,13997333,0.42175324,2558246,0.460221082
2021-09-15,288,1155779,37261,14013685,0.418827764,2627586,0.46605646
2021-09-16,352,1156131,37293,14022197,0.416191155,2658653,0.478375555
2021-09-17,351,1156482,37318,14022252,0.413784685,2658706,0.495489929
2021-09-18,349,1156831,37339,14022267,0.411246222,2658706,0.511392121
2021-09-19,283,1157114,37359,14022272,0.408613352,2658706,0.526207602
2021-09-20,198,1157312,37367,14045690,0.405304087,2714955,0.529341587
2021-09-21,207,1157519,37374,14070179,0.401902074,2787454,0.529881424
2021-09-22,391,1157910,37379,14088195,0.398613124,2862253,0.530287984
2021-09-23,583,1158493,37410,14099517,0.395613312,2943289,0.529394012
2021-09-24,532,1159025,37423,14109265,0.392604881,3010804,0.530704855
2021-09-25,493,1159518,37432,14109669,0.389808928,3012349,0.54307859
2021-09-26,485,1160003,37440,14109731,0.387098853,3012508,0.554725732
2021-09-27,424,1160427,37445,14127658,0.383945573,3094527,0.55103486
2021-09-28,250,1160677,37449,14147843,0.380684578,3186718,0.546781082
2021-09-29,385,1161062,37455,14159512,0.377615643,3273283,0.544321016
2021-09-30,532,1161594,37468,14168456,0.374630472,3349921,0.54360401
2021-10-01,548,1162142,37476,14176269,0.371655494,3419667,0.543756554
2021-10-02,525,1162667,37484,14176635,0.368862797,3421779,0.55425481
2021-10-03,486,1163153,37494,14176720,0.366112484,3422231,0.563864392
2021-10-04,396,1163549,37500,14192183,0.362959561,3493783,0.561265668
2021-10-05,351,1163900,37506,14208016,0.359755987,3569799,0.558868129
2021-10-06,503,1164403,37512,14215591,0.356728183,3646808,0.556759221
2021-10-07,639,1165042,37533,14221785,0.353676248,3731864,0.55345047
2021-10-08,684,1165726,37542,14227505,0.350584708,3816372,0.550482384
2021-10-09,674,1166400,37554,14227801,0.347618808,3817805,0.559958538
2021-10-10,732,1167132,37564,14227825,0.344716556,3818084,0.569519858
2021-10-11,629,1167761,37571,14228111,0.341858039,3818790,0.579089099
2021-10-12,414,1168175,37574,14293726,0.337364199,3909465,0.575135236
2021-10-13,577,1168752,37578,14347278,0.333406819,4023170,0.568688128
2021-10-14,831,1169583,37583,14379832,0.330109668,4136419,0.563130408
2021-10-15,1063,1170646,37594,14398096,0.327245056,4251842,0.558010686
2021-10-16,1104,1171750,37597,14398528,0.324844804,4255691,0.568082039
2021-10-17,972,1172722,37609,14398568,0.322542504,4256365,0.578015795
2021-10-18,841,1173563,37620,14445710,0.319177074,4360780,0.573737183
2021-10-19,682,1174245,37623,14500221,0.315776744,4487640,0.567761048
2021-10-20,898,1175143,37628,14561925,0.312382504,4624600,0.561612913
2021-10-21,1198,1176341,37640,14610439,0.309491993,4771543,0.555075807
2021-10-22,1383,1177724,37651,14666006,0.306568741,4929146,0.548247662
2021-10-23,1303,1179027,37662,14667257,0.304999571,4936163,0.559026149
2021-10-24,1266,1180293,37669,14667321,0.303522929,4937003,0.570016758
2021-10-25,1062,1181355,37685,14746194,0.300376221,5100856,0.562217195
2021-10-26,835,1182190,37691,14840801,0.297195263,5294739,0.553016724
2021-10-27,1288,1183478,37697,14942482,0.294007003,5485438,0.545907995
2021-10-28,1437,1184915,37719,15043593,0.291027396,5674577,0.540220341
2021-10-29,1643,1186558,37729,15134851,0.288490753,5852894,0.536662305
2021-10-30,1427,1187985,37743,15139123,0.28792718,5873429,0.548302948
2021-10-31,1421,1189406,37757,15139383,0.287512483,5875688,0.561176045
2021-11-01,1149,1190555,37777,15139909,0.287113164,5877462,0.573816189
2021-11-02,932,1191487,37782,15233854,0.284753929,6016336,0.573077719
2021-11-03,1000,1192487,37790,15322206,0.282656412,6209703,0.568198256
2021-11-04,1507,1193994,37794,15403341,0.280821976,6396045,0.565145459
2021-11-05,1760,1195754,37814,15474038,0.279289421,6561723,0.564547167
2021-11-06,1875,1197629,37841,15478283,0.279060987,6587449,0.576270973
2021-11-07,1797,1199426,37862,15478495,0.27897291,6590266,0.58941106
2021-11-08,1570,1200996,37879,15521364,0.278111531,6708600,0.591832517
2021-11-09,1251,1202247,37883,15580489,0.276858309,6856429,0.592281608
2021-11-10,1710,1203957,37895,15637772,0.275528489,6991316,0.594215784
2021-11-11,1848,1205805,37917,15692557,0.274094775,7108121,0.59752132
2021-11-12,1896,1207701,37936,15740368,0.27264078,7237513,0.599415117
2021-11-13,1790,1209491,37951,15744158,0.271856472,7263613,0.609703624
2021-11-14,1811,1211302,37975,15744421,0.271170158,7266406,0.621204873
2021-11-15,1476,1212778,38001,15790858,0.269676992,7393173,0.621388048
2021-11-16,1196,1213974,38005,15837393,0.268328316,7520228,0.621908857
2021-11-17,1541,1215515,38016,15879890,0.266896567,7643661,0.62275026
2021-11-18,1716,1217231,38049,15917656,0.265406305,7755603,0.624018948
2021-11-19,1784,1219015,38079,15949581,0.263877848,7869324,0.624547966
2021-11-20,1838,1220853,38094,15951731,0.262773116,7887604,0.632226368
2021-11-21,1844,1222697,38117,15951867,0.26173146,7889373,0.640357165
2021-11-22,1469,1224166,38149,15983172,0.260163774,7982454,0.640479024
2021-11-23,1221,1225387,38161,16017338,0.258514942,8078154,0.640690546
2021-11-24,1518,1226905,38175,16049704,0.256835458,8172376,0.641351525
2021-11-25,1754,1228659,38218,16080838,0.255088079,8256200,0.642774188
2021-11-26,1709,1230368,38245,16109405,0.253287758,8343179,0.643404479
2021-11-27,1759,1232127,38282,16112391,0.251866891,8362697,0.648700158
2021-11-28,1517,1233644,38313,16112675,0.250515566,8365305,0.65452615
2021-11-29,1211,1234855,38343,16132684,0.248855674,8469156,0.6518628
2021-11-30,944,1235799,38346,16160196,0.247013122,8597628,0.647692656
2021-12-01,1134,1236933,38356,16184306,0.245189797,8722522,0.644041803
2021-12-02,1476,1238409,38403,16207494,0.243328346,8839797,0.640827583
2021-12-03,1332,1239741,38439,16229245,0.241464923,8956640,0.63749412
2021-12-04,955,1240696,38465,16231642,0.239884331,8977959,0.640947276
2021-12-05,1275,1241971,38501,16231881,0.238359929,8981027,0.645229325
2021-12-06,895,1242866,38531,16255875,0.236480943,9103943,0.64052776
2021-12-07,765,1243631,38535,16279459,0.234598504,9235356,0.635734398
2021-12-08,998,1244629,38541,16279736,0.233038238,9237946,0.640018793
2021-12-09,1160,1245789,38600,16303565,0.231044929,9335691,0.637030386
2021-12-10,952,1246741,38638,16323840,0.229095644,9428193,0.634289224
2021-12-11,1011,1247752,38646,16326542,0.227392677,9450374,0.636321481
2021-12-12,1097,1248849,38686,16326873,0.225751486,9453483,0.639376863
2021-12-13,840,1249689,38716,16349781,0.223790324,9567500,0.634638331
2021-12-14,690,1250379,38723,16370757,0.221875258,9677098,0.630672652
2021-12-15,775,1251154,38727,16389950,0.220010891,9776250,0.62787737
2021-12-16,1014,1252168,38773,16406679,0.218197354,9865115,0.626010554
2021-12-17,966,1253134,38812,16421216,0.216405726,9944941,0.624846767
2021-12-18,925,1254059,38840,16423016,0.214778334,9961707,0.627755569
2021-12-19,807,1254866,38864,16423165,0.213214618,9963869,0.631418906
2021-12-20,690,1255556,38885,16438202,0.211475918,10055431,0.629189506
2021-12-21,515,1256071,38894,16452589,0.209757233,10142787,0.627535951
2021-12-22,714,1256785,38900,16465249,0.208084437,10216349,0.626908254
2021-12-23,922,1257707,38954,16475447,0.206516156,10273792,0.627119543
2021-12-24,838,1258545,38984,16477964,0.20501846,10289527,0.6296386
2021-12-25,816,1259361,39013,16477965,0.203510515,10289608,0.63281224
2021-12-26,658,1260019,39034,16478084,0.202035997,10290692,0.635549212
2021-12-27,417,1260436,39056,16494003,0.200389837,10421566,0.630014766
2021-12-28,509,1260945,39059,16510975,0.198736335,10602622,0.622061854
2021-12-29,773,1261718,39063,16527376,0.197097804,10796674,0.61413787
2021-12-30,927,1262645,39096,16542417,0.195466039,10983645,0.607178864
2021-12-31,1007,1263652,39115,16545952,0.193972429,11032441,0.608520645
2022-01-01,1059,1264711,39140,16545957,0.192492503,11032538,0.612675266
2022-01-02,808,1265519,39162,16546013,0.191023313,11033314,0.616534756
2022-01-03,455,1265974,39173,16562668,0.189410717,11179339,0.61208679
2022-01-04,593,1266567,39174,16580469,0.187807865,11312806,0.608869477
2022-01-05,998,1267565,39177,16593123,0.186292457,11424451,0.607172074
2022-01-06,1532,1269097,39207,16620883,0.1846127,11520059,0.606377554
2022-01-07,1829,1270926,39232,16649627,0.182965828,11611265,0.605847905
2022-01-08,2023,1272949,39251,16651747,0.181695136,11622371,0.60958461
2022-01-09,1912,1274861,39272,16651951,0.180473511,11624310,0.613657388
2022-01-10,1804,1276665,39285,16681597,0.17897278,11718680,0.612696879
2022-01-11,1859,1278524,39289,16708468,0.177548714,11797331,0.612819413
2022-01-12,2612,1281136,39290,16732350,0.176186488,11864342,0.613643417
2022-01-13,3325,1284461,39331,16755143,0.174869481,11922015,0.614838866
2022-01-14,3903,1288364,39355,16776351,0.173599342,11977934,0.61600877
2022-01-15,4714,1293078,39376,16778283,0.172594484,11985837,0.619622547
2022-01-16,4791,1297869,39394,16778381,0.171660175,11986557,0.62351185
2022-01-17,4247,1302116,39426,16801372,0.170512926,12048587,0.624142366
2022-01-18,3971,1306087,39427,16819660,0.169481294,12098642,0.625540918
2022-01-19,5764,1311851,39431,16838868,0.168483288,12149977,0.626766322
2022-01-20,6714,1318565,39456,16853772,0.16759674,12194323,0.62793858
2022-01-21,8094,1326659,39474,16865043,0.166721169,12234559,0.628777465
2022-01-22,8109,1334768,39497,16866073,0.165910112,12240171,0.630904116
2022-01-23,7690,1342458,39512,16866140,0.165151917,12240871,0.632925826
2022-01-24,8076,1350534,39535,16882522,0.164261104,12287169,0.632436012
2022-01-25,8485,1359019,39543,16899071,0.163352202,12327154,0.632339267
2022-01-26,12007,1371026,39547,16914625,0.162431818,12361410,0.632354994
2022-01-27,14209,1385235,39594,16928829,0.161506027,12391762,0.632146136
2022-01-28,15658,1400893,39620,16939722,0.160607362,12422239,0.631567388
2022-01-29,15674,1416567,39653,16940593,0.159789034,12426886,0.632069636
2022-01-30,15681,1432248,39684,16940665,0.159006708,12427381,0.632507035
2022-01-31,14484,1446732,39721,16956999,0.158069222,12468455,0.630719152
2022-02-01,13374,1460106,39733,16972437,0.157110868,12502063,0.629361825
2022-02-02,19192,1479298,39742,16987635,0.156139203,12530915,0.628134482
2022-02-03,19439,1498737,39824,17001779,0.155161203,12557803,0.626753418
2022-02-04,21103,1519840,39867,17016006,0.154150874,12583575,0.625232571
2022-02-05,20700,1540540,39930,17017021,0.153273259,12586343,0.624747173
2022-02-06,19224,1559764,39987,17017124,0.152415126,12586694,0.624227559
2022-02-07,17054,1576818,40060,17033674,0.151377009,12616626,0.622098663
2022-02-08,14827,1591645,40087,17049516,0.150315547,12643360,0.620166126
2022-02-09,20671,1612316,40111,17063638,0.149242933,12667239,0.618307713
2022-02-10,20320,1632636,40273,17076680,0.148120078,12688968,0.616419303
2022-02-11,21042,1653678,40370,17088674,0.146953452,12709275,0.614487353
2022-02-12,20419,1674097,40464,17089674,0.145887573,12711551,0.613359707
2022-02-13,19947,1694044,40558,17089782,0.144836312,12711852,0.612224431
2022-02-14,15812,1709856,40666,17102604,0.143680395,12733536,0.609947966
2022-02-15,14506,1724362,40698,17114950,0.142496376,12755797,0.60765812
2022-02-16,19531,1743893,40735,17127877,0.141259502,12778389,0.605318568
2022-02-17,20466,1764359,40936,17140062,0.139996774,12800249,0.602921172
2022-02-18,19920,1784279,41067,17151980,0.138707318,12821204,0.600503628
2022-02-19,19348,1803627,41196,17152902,0.137508063,12823148,0.598961945
2022-02-20,17769,1821396,41347,17152951,0.136337241,12823321,0.597442925
2022-02-21,12869,1834265,41491,17166705,0.135058331,12857284,0.59428052
2022-02-22,11517,1845782,41526,17180549,0.133779751,12890629,0.591235715
2022-02-23,15817,1861599,41571,17193028,0.132471414,12921794,0.58833515
2022-02-24,17240,1878839,41795,17205816,0.13112338,12950672,0.585522679
2022-02-25,16636,1895475,41919,17218464,0.12974981,12977928,0.582789074
2022-02-26,16216,1911691,42070,17219587,0.128486322,12980317,0.581208336
2022-02-27,13514,1925205,42200,17219664,0.127251017,12980551,0.579687453
2022-02-28,10261,1935466,42353,17235458,0.125918666,13022686,0.576231064
2022-03-01,9239,1944705,42381,17248605,0.124628601,13062916,0.572963643
2022-03-02,13074,1957779,42411,17257219,0.12335282,13088802,0.570368286
2022-03-03,13531,1971310,42683,17265159,0.122049451,13112571,0.567848573
2022-03-04,13195,1984505,42809,17275001,0.120707077,13145481,0.5649172
2022-03-05,11882,1996387,42955,17276017,0.119432778,13149930,0.563266469
2022-03-06,11174,2007561,43077,17276081,0.118176432,13150137,0.561772654
2022-03-07,8218,2015779,43226,17283513,0.116894699,13174631,0.559183249
2022-03-08,7330,2023109,43260,17289883,0.115631225,13197230,0.556721621
2022-03-09,10699,2033808,43283,17296226,0.11435994,13220563,0.554284843
2022-03-10,11351,2045159,43527,17302071,0.113045592,13243121,0.551863166
2022-03-11,10749,2055908,43659,17310032,0.111697392,13278172,0.548904764
2022-03-12,10281,2066189,43785,17310996,0.110399889,13284819,0.547184673
2022-03-13,9279,2075468,43879,17311056,0.109159337,13285113,0.545714833
2022-03-14,6420,2081888,44005,17317114,0.107912345,13309257,0.543215335
2022-03-15,6169,2088057,44039,17322672,0.106647263,13333752,0.540763557
2022-03-16,8504,2096561,44062,17327885,0.105354946,13357845,0.538338513
2022-03-17,9122,2105683,44246,17332728,0.104047375,13380698,0.535920661
2022-03-18,8505,2114188,44339,17339385,0.102727049,13415555,0.533002418
2022-03-19,7148,2121336,44440,17340173,0.101447224,13422735,0.531231776
2022-03-20,6172,2127508,44518,17340215,0.100215795,13423030,0.529705593
2022-03-21,4273,2131781,55965,17346060,0.098971346,13445644,0.527242504
2022-03-22,3567,2135348,55976,17351746,0.097730388,13468155,0.524838416
2022-03-23,1773,2137121,55992,17357143,0.096494326,13489806,0.522436688
2022-03-24,5470,2142591,56147,17362157,0.095248285,13510080,0.520002353
2022-03-25,4821,2147412,56222,17369289,0.09398172,13539857,0.517181976
2022-03-26,4312,2151724,56298,17370235,0.092766233,13546512,0.515304288
2022-03-27,3640,2155364,56381,17370299,0.091586925,13546728,0.513644789
2022-03-28,2611,2157975,56446,17376919,0.090393376,13567000,0.511137861
2022-03-29,2058,2160033,56464,17382517,0.089220792,13586069,0.508678882
2022-03-30,3511,2163544,56467,17387571,0.08805375,13605113,0.506168528
2022-03-31,3564,2167108,56580,17391916,0.086896989,13622595,0.503640064
2022-04-01,3157,2170265,56637,17397947,0.085734763,13646239,0.500863736
2022-04-02,2721,2172986,56689,17398622,0.084604187,13651059,0.498812514
2022-04-03,2499,2175485,56750,17398645,0.083494072,13651249,0.496898062
2022-04-04,1505,2176990,56798,17403531,0.082370662,13669465,0.494235375
2022-04-05,1309,2178299,56809,17407650,0.08125912,13687283,0.491597052
2022-04-06,2269,2180568,56822,17411401,0.080171382,13705659,0.488913401
2022-04-07,2497,2183065,56912,17414791,0.07910046,13722708,0.486218423
2022-04-08,2197,2185262,56955,17419405,0.078022539,13743537,0.483356888
2022-04-09,1984,2187246,56997,17420194,0.076958227,13749160,0.481063321
2022-04-10,1593,2188839,57041,17420219,0.075903669,13749302,0.47892751
2022-04-11,1151,2189990,57081,17423964,0.074833159,13766097,0.47611256
2022-04-12,895,2190885,57094,17427019,0.07377907,13783684,0.47327652
2022-04-13,1664,2192549,57098,17429960,0.072731744,13800362,0.47046052
2022-04-14,1760,2194309,57167,17433356,0.071683771,13822057,0.467431807
2022-04-15,1565,2195874,57205,17433376,0.070646337,13822229,0.465125196
2022-04-16,1453,2197327,57231,17433398,0.069593687,13822410,0.462782184
2022-04-17,853,2198180,57263,17433409,0.068544458,13822492,0.460391131
2022-04-18,725,2198905,57270,17436777,0.067482207,13837718,0.45741542
2022-04-19,744,2199649,57275,17439700,0.066457417,13853644,0.454435501
2022-04-20,1498,2201147,57283,17442466,0.065454686,13870354,0.451422732
2022-04-21,1720,2202867,57325,17444878,0.064458725,13885444,0.448430157
2022-04-22,1590,2204457,57351,17447970,0.063448931,13903180,0.445329454
2022-04-23,1438,2205895,57375,17448501,0.062445088,13907349,0.442696521
2022-04-24,1109,2207004,57375,17448517,0.061443162,13907483,0.440180991
2022-04-25,774,2207778,57376,17451396,0.060445566,13922473,0.437163918
2022-04-26,626,2208404,57387,17453877,0.059485604,13937406,0.43416221
2022-04-27,1137,2209541,57468,17456314,0.058548515,13951499,0.431177498
2022-04-28,1367,2210908,57495,17458845,0.057625723,13966022,0.428141588
2022-04-29,1297,2212205,57509,17461686,0.056693765,13984385,0.424962183
2022-04-30,1258,2213463,57527,17462165,0.055775981,13989271,0.422236162
2022-05-01,1136,2214599,57539,17462165,0.054877917,13989281,0.419657846
2022-05-02,818,2215417,57541,17464871,0.053983012,14007633,0.416459369
2022-05-03,705,2216122,57544,17467460,0.053106976,14025981,0.4132733
2022-05-04,1414,2217536,57580,17470089,0.052269615,14046283,0.410020255
2022-05-05,1746,2219282,57597,17472573,0.051464756,14067083,0.406717982
2022-05-06,1749,2221031,57614,17475343,0.050656407,14090800,0.40331549
2022-05-07,1700,2222731,57629,17475867,0.049854375,14096682,0.400485125
2022-05-08,1539,2224270,57637,17475896,0.04908267,14096952,0.397825725
2022-05-09,1097,2225367,57639,17478678,0.04833276,14118038,0.394528199
2022-05-10,956,2226323,57642,17481142,0.047627147,14136654,0.391300337
2022-05-11,1936,2228259,57667,17483597,0.046960685,14158789,0.387935566
2022-05-12,2401,2230660,57680,17486071,0.046327247,14181294,0.384527319
2022-05-13,2569,2233229,57697,17488601,0.045691928,14207075,0.381024376
2022-05-14,2492,2235721,57714,17489168,0.045061975,14215412,0.378064198
2022-05-15,2324,2238045,57722,17489212,0.044433896,14216086,0.375342471
2022-05-16,1758,2239803,57725,17492088,0.043826236,14242002,0.371955912
2022-05-17,1489,2241292,57733,17495056,0.043249787,14270161,0.368567683
2022-05-18,2976,2244268,57754,17498197,0.042700427,14300174,0.365157945
2022-05-19,3575,2247843,57767,17501109,0.042174184,14328204,0.36180812
2022-05-20,3567,2251410,57782,17504281,0.041644781,14359133,0.358409661
2022-05-21,3116,2254526,57794,17504647,0.041123763,14364419,0.355744583
2022-05-22,2994,2257520,57802,17504698,0.040618483,14365132,0.353237306
